........................
....M.....____..........
........................
...........M.....___....
.........____...........
.H......................
________________________